هناك ، أمام بيانات السائح تماما .	MSA
لم اسمع بهذا العنوان من قبل بالقرب من هنا .	MSA
استمر في السير في هذا الطريق حتى تجد صيدلية .	MSA
كم تكلفة الإفطار ؟	MSA
كيف أستطيع مساعدتك ؟	MSA
اتجه يسارا عند الناصية الثالثة .	MSA
هل تحب أن تضع قشدة وسكر في قهوتك ؟	MSA
هل يمكنكم صرف الشيك ذو المائتي دولار الخاص بي ؟	MSA
إذا حدث ذلك ، من فضلك أتصل بي .	MSA
أين المقهى ؟	MSA
أريد جاكيت للأطفال .	MSA
حسنا . إنها تتكلف خمسة وثمانون دولارا في البريد العادي وثلاثة دولارات في التوصيل الخاص .	MSA
هل لديك أحذية حريمي عند أصابع القدم ؟	MSA
هل ستواجهني أية صعوبات في الجمارك ؟	MSA
لا ، هل لي أن أقترح أخذ غرفة ذات سريرين للاستخدام الفردي ؟ فنحن لدينا واحدة .	MSA
أريد تمويج متقارب لشعري ، من فضلك .	MSA
هي تريد بيرة .	MSA
صباح الخير . كيف حالك .	MSA
أسف أنني بحاجة إلى أن أطلع على أي مستند لتحديد الهوية .	MSA
أي نوع من الملابس ؟	MSA
صار هونيك ، بالظبط قدام مكتب استعلامات السياح .	BEI
بعمري ما سمعت بهالعنوان هون .	BEI
روح دغري لحتى تشوف صيدلية .	BEI
أدي حق الترويقة ؟	BEI
كيف فيني ساعدك ؟	BEI
روح شمال عالزاوية التالتة .	BEI
عبالك كريمة و سكر بقهوتك ؟	BEI
فيك تصرفلي الشيك تبعي تبع المتين دولار ؟	BEI
إذا لازم يبين ، عمل معروف دقلي .	BEI
وين القهوة ؟	BEI
بدي كنزة للولاد .	BEI
أوك ، بيكلف خمس و تمانين سنت للإيميل العادي و تلاتي دولار بالظبط زيادة للتوصيل الخاص .	BEI
رح يكون في شي صعوبات مع الجمارك ؟	BEI
عندك صبابط رسمي تبع الأصابيع العراض ؟	BEI
لاء . بد هيك فيي إقترح أوضة بتختين لإستخدام شخص ؟ عنا واحدة .	BEI
بدي كيرلي ضيق ، إذا بتريد .	BEI
بدا بيرة .	BEI
صباحو . كيفك ؟	BEI
للأسف محتاج اشوف أي اثبات شخصية .	BEI
أي نوع صوص ؟	BEI
ده قدامك هناك ، يادوبك قدام مكتب استعلامات السياحة .	CAI
عمري ما سمعت عن العنوان ده هنا .	CAI
أمشي علطول لحد ما تلقي صيدلية .	CAI
بكام الفطار ؟	CAI
ازاي أقدر اساعدك ؟	CAI
احود شمال عند الناصية التالته .	CAI
تحب كريمة و سكر في قهوتك ؟	CAI
ممكن تصرفلي شيك بميتين دولار ؟	CAI
لو لازم يظهر ، لو سمحت كلمني .	CAI
فين القهوة ؟	CAI
عايز بلوفر اطفال .	CAI
اوكيه . ده بيكلف خمسه و تمانين سنت للبريد العادي أو زيادة تلات دولارات بالظبط للبريد المخصوص .	CAI
حالاقي مشاكل مع الجمارك ؟	CAI
عندك جزم رسمي واسعه من قدام ؟	CAI
لأ . ممكن انصح اوضة بسريرين يقعد فيها واحد بس ؟ احنا عندنا واحده .	CAI
عاوز كيرلي جامد ، لو سمحت .	CAI
نفسها في بيرة .	CAI
صباح الخير . عامل ايه ؟	CAI
متأسف بس محتاج أشوف أى مستند اثبات شخصية .	CAI
أى نوع صوص ؟	CAI
هو ذاك الصوب ، بالضبط جدام استعلامات السياح بالضبط .	DOH
ما قط سمعت بهالعنوان في هالمنطقة من قبل .	DOH
امش سيده لين تشوف صيدلية .	DOH
بكم الريوق ؟	DOH
شلون اقدر اساعدك ؟	DOH
خذ ثالث لفة يسار .	DOH
بغيت سكر وكريمة في القهوة ؟	DOH
ممكن تصرف لي قيمة جيكي بو ميتين دولار كاش ؟	DOH
اذا المفروض يصير ، اتصل فيني .	DOH
وين الكوفي شوب ؟	DOH
بغيت فانلة يهال .	DOH
اوكي . يكلف خمسة وثمانين سنت بالبريد العادي وثلاث دولارات بالضبط زيادة حق التسليم الخاص .	DOH
بتكون في اي صعوبات مع الجمارك ؟	DOH
عندك جواتي رسمية حق الرجول العريضة ؟	DOH
لا . بغيت غرفة مزدوجة بس حق استخدام فردي ؟ عندنا وحدة .	DOH
ابغي كيرلي ضيق ، لو سمحت .	DOH
هي تبغي بير .	DOH
صباح الخير . شلونك ؟	DOH
مسامحة بس لازم اشوف شي يثبت الهوية .	DOH
اي نوع صوص ؟	DOH
راه تما ، مقابل مكتب استعلامات السياح بالضبط .	RAB
ما عمري سمعت هاد العنوان هنايا .	RAB
سير نيشان حتا تشوف صيدلية .	RAB
شحال كا يدير الفطور ؟	RAB
كيفاش نقدر نعاونك ؟	RAB
مع القنت التالت دور على ليسر .	RAB
واش تبغي لاكريم و السكر في القهوة ديالك ؟	RAB
تقدر تخلص الشيك ديالي ديال ميتين دولار ؟	RAB
إلا خصو يبان ، عيط ليا عفاك .	RAB
فين القهوة ؟	RAB
بغيت تريكو ديال الدراري الصغار .	RAB
واخا . كايدير خمسة و تمانين دولار للبريد العادي و تلاتة دولار بالضبط زيادة للتوصيل الخاص .	RAB
واش غادي نلقا شي صعوبة مع الديوانا ؟	RAB
واش عندك صبابط رسمية واسعة عند الصبع ؟	RAB
لا . نقدر نقتارح ثنائية لواحد ؟ عندنا وحدة .	RAB
بيرمانونت مجهد ، عافاك .	RAB
بغات بيرا .	RAB
صباح الخير . كي داير ؟	RAB
سمح ليا خصني نشوف شي وثيقة ديال الهوية .	RAB
إينا نوع ديال الصوص ؟	RAB
اهوكا غادي ، بالضبط قدام البيرو متاع الارشادات السياحية .	TUN
عمري ما سمعت بالادريسة هاذي هوني .	TUN
امشي طول طول حتى لين تشوف صيدلية .	TUN
بقداش فطور الصباح ؟	TUN
كيفاش انجم نعاونك ؟	TUN
دور الدورة الثالثة عاليسار .	TUN
تحب كريمة و سكر في قهوتك ؟	TUN
تنجم تصبلي ها الشاك بميتين دولار متاعي ؟	TUN
لو لازم يضهر ، كلمني عيشك .	TUN
ويني القهوة ؟	TUN
نحب مريول متاع صغار .	TUN
باهي . مراسلة عادية بخمسة و ثمانين سنت وزايدة تلاثة دولارات بالضبط للمراسلة اللي من النوع لبخاص .	TUN
باش نلقى مشكلة مع الديوانة ؟	TUN
تبيعو صبابط رسمية يكونو واسعين من شيرة الصوابع ؟	TUN
لا . تحب بيت فيها زوز فروشات نحسبوها لشخص برك ؟ عنا وحدة .	TUN
نحب برمانونت قوية ، عيشك .	TUN
تحب كعبة بيرا .	TUN
صباح الخير . لاباس ؟	TUN
سامحني لازمني نشوف اوراقك .	TUN
شنوة الصوص ؟	TUN
هو هناك ، قدام الاستعلامات السياحية على طول .	ALX
عمرى ما سمعت عن العنوان دة هنا .	ALX
امشى على طول لحد ما تشوف صيدلية .	ALX
بكام الفطار ؟	ALX
إزاى أقدر أساعدك ؟	ALX
روح شمال عند الناصية الثالثة .	ALX
تحب كريمة وسكر فى القهوة بتاعتك ؟	ALX
ممكن تدفع الشيك بتاعى اللى بميتين دولار ؟	ALX
لو المفروض يظهر ، كلمنى لو سمحت .	ALX
فين الكوفى شوب ؟	ALX
عاوز بلوفر أطفال .	ALX
أوكى . بيكلف خمسة و ثمانين سنت للإيميل العادى و ثلاثة دولار بالظبط زيادة للتوصيل الخاص .	ALX
هلاقى أى صعوبة مع الجمارك ؟	ALX
عندك شوز رسمية بوش واسع ؟	ALX
لأ . ممكن أقترح أوضة بسريرين لشخص واحد كحل بديل ؟ إحنا عندنا واحدة .	ALX
عاوز كيرلى جامد ، من فضلك .	ALX
هى عاوزة بيرة .	ALX
صباح الخير . عامل إيه ؟	ALX
للأسف هحتاج أشوف بطاقة تحقيق شخصية .	ALX
إيه نوع الصوص ؟	ALX
راهو لهيك ، بالضبط قدام المكتب تع معلومات السياح .	ALG
جامي سمعت بهاذ العنوان في هاذ الجيهة .	ALG
امشي قبالة حتى تشوف صيدلية .	ALG
شحال القهوة تع الصباح ؟	ALG
كيفاش نقدر نعاونك ؟	ALG
دور على اليسار في الطريق الثالثة .	ALG
تحب الكريمة و السكر فالقهوة ديالك ؟	ALG
تقدر تصرفلي الميتين دولار تاوعي لي راهوم فالشاك ؟	ALG
ويدا لازم يظهر ، عيطلي من فضلك .	ALG
وين جايا القهوة ؟	ALG
راني حاب تريكو تع أطفال .	ALG
ايه . معنتها خمسة و ثمانون سنت للبرية العادية ، و تزيدلها ثلاثة دولار بالضبط باش تبعثها اكسبرس .	ALG
راني حاب نعرف ويدا يكون عندي مشكل مع الجمارك ؟	ALG
عندكم صبابط رسمية عراض من القدام ؟	ALG
لالا . نقترح عليك غرفة فيها زوج بناك لشخص واحد . كاينة واحدة واجدة .	ALG
راني حاب برمانونت قوي .	ALG
راهي حابة بيرة .	ALG
صباح الخير . واش راك ؟	ALG
سامحني لازم نطلب منك بطاقة تعريف .	ALG
واش من النوع تع الصوص ؟	ALG
هيو هناك ، بالزبط مقابل مكتب المعلومات السياحية .	AMM
أنا ما سمعت أبداً عن هاد العنوان في المنطقة هون .	AMM
امشي دغري لعند ما تشوف صيدلية .	AMM
كم سعر الفطور ؟	AMM
كيف بقدر أساعدك ؟	AMM
روح يسار من عند الدخلة التالتة .	AMM
بتحب الكريمة والسكر مع قهوتك ؟	AMM
ممكن تصرفلي الشيك بميتين دولار ؟	AMM
ازا بده يظهر ، لو سمحت كلمني .	AMM
وين الكوفي شوب ؟	AMM
بدي بلوفر أطفال .	AMM
طيب . بكلف تمنية وخمسين سنت للبريد العادي وتلاتة دولار بالزبط اضافية للتوصيل الخاص .	AMM
راح يكون عندي أي صعوبة في التعامل مع الجمارك ؟	AMM
عندك كندرة رسمية واسعة من عند الأصابع ؟	AMM
لا . ممكن أقترح عليك بدالها غرفة مزدوجة تستخدمها استخدام فردي . عنا وحدة .	AMM
أنا بدي اياه كتير مموج ، لو سمحت .	AMM
بدها خمرة .	AMM
صباح الخير . كيف حالك ؟	AMM
أسف راح أحتاج أشوف اثبات هوية .	AMM
أي نوع من الصوص ؟	AMM
هناك ، قدام مكتب ارشادات السياح على طول .	ASW
انا عمرى ماسمعت عن العنوان ده هنا .	ASW
امشي على طول لغاية متشوف صيدلية .	ASW
بكام الفطار ده ؟	ASW
إزاي أقدر اساعدك ؟	ASW
امشي شمال لغاية الناصية التالتة .	ASW
عايز كريمة وسكر على القهوة بتاعتك ؟	ASW
ممكن تصرفلى الشيك بتاعى بمتين دولار ؟	ASW
لو المفروض يظهر ، كلمني .	ASW
فين الكوفي شوب ؟	ASW
كنت عايز بلوفر اطفال .	ASW
ماشي . هتكلف خمسة وتمانين سنت لو بالبريد العادي وتلات دولارات بالظبط زيادة لو بالتوصيل الخاص .	ASW
هو انا هلاقي اى صعوبة مع الجمارك ؟	ASW
عندك جزم رسمية بوش عريض ؟	ASW
لا . بس ممكن اقترح بدل من كدة أوضة مزدوجة لاستخدام فرد ؟ احنا عندنا واحدة .	ASW
كنت عاوز كيرلى كويس ، لو سمحت .	ASW
هي عايزة بيرة .	ASW
صباح الخير . عامل ايه ؟	ASW
معلش كنت عايز اشوف تحقيق الشخصية .	ASW
اي نوع صوص ؟	ASW
موجود هنيك ، قدام مكتب معلومات السياح بالزبط .	DAM
ما سمعت بهيك عنوان هون من قبل .	DAM
إمشي مباشرة لحد ما تشوف صيدلية .	DAM
بأديش الفطور ؟	DAM
كيف فيني ساعدك ؟	DAM
لف عالشمال بالدخلة التالتة .	DAM
بتحب كريما وسكر مع القهوة ؟	DAM
ممكن تصرفلي هاد الشيك بقيمة ميتين دولار ؟	DAM
إذا بين ، اتصل فيني رجاءً .	DAM
وين القهوة ؟	DAM
بدي كنزة أطفال .	DAM
أوك . هاد بكلف خمسة وتمانين سنت بالبريد العادي وزيادة تلاتة دولار بالظبط للتوصيل الخاص .	DAM
ممكن واجه صعوبة مع الجمارك ؟	DAM
بلاقي عندك حذاء رسمي للرجلين العراض ؟	DAM
لاء . ممكن اقترح وحدة لشخصين للاستخدام الفردي بدالها ؟ عنا وحدة .	DAM
بدي كيرلي ضيق ، إذا سمحت .	DAM
بدها بيرة .	DAM
صباح الخير . كيفك ؟	DAM
للأسف أنا مضطر إني شوف شي بيثبت الهوية .	DAM
أي نوع صوص ؟	DAM
شوفه هناك ، قدام مكتب المعلومات السياحية بالضبط .	JED
ماقد سمعت بدا العنوان هنا .	JED
امشي سيدا لين ما تلاقي الصيدلية .	JED
بكم الفطور ؟	JED
كيف أقدر اساعدك ؟	JED
روح يسار عند الزواية الثالثة .	JED
تبا كريم وسكر في قهوتك ؟	JED
ممكن تعطيني كاش للشيك دا الميتين دولار ؟	JED
اذا لازم يظهر ، اتصل عليا لو سمحت .	JED
فين المقهى ؟	JED
أبا سترة اطفال .	JED
اوك . يكلف خمسة وتمانين سنت للأيميل العادي وزيادة تلاتة دولار بالضبط للتوصيل الخاص .	JED
ممكن اواجه صعوبات في الجمارك ؟	JED
عندك جزم رسمية واسعة عند الأصابع ؟	JED
لا . اقترحلك غرفة بسريرين لاستخدام شخص واحد بدال كدة ؟ عندنا وحدة .	JED
أبا شعري مجعد كثير ، لو سمحت .	JED
هيا تبا بيرة .	JED
صباح الخير ، كيفك ؟	JED
معليش لازم اشوف اثبات هوية .	JED
اية نوع من الصوص ؟	JED
هناك ، قدام مكتب استعلامات السياح بالزبط .	JER
عمري ما سمعت هدا العنوان هون .	JER
خليك ماشي دغري لتلاقي صيدلية .	JER
قديش الفطور ؟	JER
كيف بقدر أساعدك ؟	JER
روح شمال عند الكورنر التالتة .	JER
بتحب السكر و الكريمة مع قهوتك ؟	JER
بتقدر تصرفلي شك الميتين دولار تبعي ؟	JER
ازا لازم يظهر ، احكي معي .	JER
وين الكوفي شوب ؟	JER
بدي جرزة أطفال .	JER
طيب . بتكلف خمسة و تمانين سنت للبريد العادي و تلات دولارات بالزبط اضافية للتوصيل الخاص .	JER
رح ألاقي صعوبات في الجمارك ؟	JER
في عندك كندرة رسمي عريضة ؟	JER
لأ . تاخد غرفة بتختين لاستعمال واحد ؟ في عنا واحدة .	JER
بدي كيرلي صغير ، لو سمحت .	JER
بدها بيرة .	JER
صباح الخير . كيف حالك ؟	JER
متأسف محتاج اني أشوف بطاقة الهوية .	JER
شو نوع الصوص ؟	JER
هناك ، بالضبط مقابل مكتب معلومات السياح .	RIY
ما قد سمعت بهذا العنوان هنا .	RIY
امش على طول لين تلقى صيدلية .	RIY
بكم الفطور ؟	RIY
كيف اقدر اساعدك ؟	RIY
لف يسار عند ثالث زاوية .	RIY
ودك بكريمة و سكر في قهوتك ؟	RIY
تقدر تصرف لي شيك المئتين دولار حقتي ؟	RIY
اذا كان يجب ان يظهر ، الرجاء الاتصال بي .	RIY
وين المقهى ؟	RIY
ابغى سترة للأطفال .	RIY
طيب . تكلف خمس و ثمانين سنت للبريد العادي و ثلاث دولارات بالضبط إضافية للتوصيل الخاص .	RIY
هل بواجه أي صعوبة مع الجمارك ؟	RIY
عندك احذية رسمية واسعة عند الأصابع ؟	RIY
لا . اقدر اقترح عليك غرفة مزدوجة لاستخدام شخص واحد بدال هذا ؟ متوفر عندنا .	RIY
ابغى بيرم ضيق ، لو سمحت .	RIY
تبغى بيرة .	RIY
صباح الخير . كيف حالك ؟	RIY
اسف اني مضطر اشوف أي نوع من أنواع اثبات الهوية .	RIY
أي نوع من الصوص ؟	RIY
هوذاك هاناك ، قبال مكتب المعلومات السياحيه بالضبط .	SAN
ماقد سمعتش ابدا بهذا العنوان هانا .	SAN
امشي طوالي لوما تبسر صيدليه .	SAN
بكم هو الصبوح ؟	SAN
كيف اقدر اساعدك ؟	SAN
اخطى يسار عند الركن الثالث .	SAN
تشتي كريمه وسكر في القهوة ؟	SAN
تقدر تصرف لي شيك الميتين الدولار ؟	SAN
اذا لازم يظهر ، لو سمحت اتصل لي .	SAN
اين هو الكافيه ؟	SAN
أشتي سترة أطفالي .	SAN
تمام . يكلف خمسه وثمانين سنت للبريد العادي و ثلاثه دولار بالضبط زياده للتوصيل الخاص .	SAN
هل شا اواجه مشاكل مع الجمارك ؟	SAN
به معك جزمه رسميه واسعه عند الاصابع ؟	SAN
لا . ممكن اقترح عليك غرفة مزدوجة ل استخدام فرد بدله ؟ عندنا واحدة .	SAN
اشتي تجعيد قوي ، لو سمحت .	SAN
هي تشتي بيره .	SAN
صباح الخير . كيف حالك ؟	SAN
أسف مضطر اطلب منك تبرز اي شي يثيت هويتك .	SAN
ما هو نوع الصوص ؟	SAN
أوكي غادي ، قدام مكتب الإرشادات السياحية بالضبط .	SFX
أنا منعرفش الادريسة هذه قريبة من هوني .	SFX
كمل القدام لين تارى الفارمسي .	SFX
بقداش فطور الصباح ؟	SFX
كيفاش النجم نعاونك ؟	SFX
دور على الليسار مع الزنقة الثالثة .	SFX
تحب الكريمة و السكر في قهوتك ؟	SFX
تنجم تصبلي الميتين دولار من الشاك هذا ؟	SFX
لو لازم يضهر ، كلمني عيشك .	SFX
وين تجي القهوة ؟	SFX
نحب مريول للأولاد .	SFX
باهي . خمسة و ثمانين ألف في جواب عادي ، تزيد ثلاثة دولار بالظبط باش يوصلك فيسع .	SFX
باش نقابل مشاكل مع الديوانة ؟	SFX
عندك صبابط رسمية يكونو واسعين من شيرة الصوابع ؟	SFX
لا . تحب بيت بزوز فروشات لاستخدام شخص برك ؟ عندنا وحدة حاضرة .	SFX
نحب كيرلي قوي ، يعيشك .	SFX
تحب وحدة بيرة .	SFX
صباح الخير . شنحوالك ؟	SFX
سامحني لازمني نطلب منك بطاقة التعريف .	SFX
شنوة نوع الصوص ؟	SFX
هو هنيك ، قدام معلومات السياح بالضبط .	ALE
مالي سمعان من قبل بهالعنوان هون .	ALE
روح ساوي لبين ما تشوف صيدلية .	ALE
بشقد الفطور ؟	ALE
شلون بقدر أساعدك ؟	ALE
روح عاليسار عند تالت مفرق .	ALE
بتريد كريمة وسكر بقهوتك ؟	ALE
خرج تصرفلي شيك الميتين دولار تبعي ؟	ALE
إذا لازم يبين ، اتصل فيني إذا سمحت .	ALE
وين الكافيه ؟	ALE
بدي كنزة اطفال .	ALE
ماشي . بكلف خمسة وتمانين سنت بالبريد العادي وتلات دولارات بالضبط إضافية للتوصيل الخاص .	ALE
رح ألاقي شي صعوبة بالجمارك ؟	ALE
عندك حذاء رسمي عريض ؟	ALE
لا . ممكن أقترح وحدة مزدوجة للاستعمال المفرد بدالها ؟ في عنا وحدة .	ALE
بدي كيرلي قوي ، إذا ممكن .	ALE
بدها بيرة .	ALE
صباح الخير . شلونك ؟	ALE
للأسف لازم أشوف إثبات هوية .	ALE
إينا نوع من الصوص ؟	ALE
موجود هناك ، بالضبط مقابيل مكتب المعلومات السياحية .	BAG
عمري ما سامع بهيج عنوان بهل المنطقة .	BAG
اطلع كبل لحد ما تشوف الصيدلية .	BAG
شكد يكلف الريوك ؟	BAG
شلون اكدر اساعدك ؟	BAG
اخذ يسره ثالث زوية .	BAG
تحب اخليلك كريم وشكر بالكهوة مالتك ؟	BAG
ممكن تصرفلي الصك مالتي أبو الميتين دولار ؟	BAG
اذا صار شي ، رجاءً اتصل بيه .	BAG
وين صايره الكهوة ؟	BAG
اريد سترة مال أطفال .	BAG
ماشي . هاي تكلف خمسة وثمانين سنت للبريد العادي وتلث دولارات بالضبط إضافية للتسليم الخاص .	BAG
هل راح اواجه صعوبات ويه الكمارك ؟	BAG
عندك احذية رسمية ببوز عريض ؟	BAG
لا . ممكن اقترح غرفة بسريرين لشخص كشي بديل ؟ عدنا وحده .	BAG
اريد كيرلي قوي ، رجاءً .	BAG
تريد بيره .	BAG
صباح الخير ، شلونك ؟	BAG
اسف احتاج اشوف أي هويه تعريفية .	BAG
شنو نوع الصوص ؟	BAG
موجود هناك ، بالضبط كدام مكتب معلومات السياح .	BAS
ما سامع بهذا العنوان هنا ابد .	BAS
اطلع كبل لحد ما تشوف صيدلية .	BAS
ابيش الريوك ؟	BAS
شلون اكدر اساعدك ؟	BAS
اخذ يسرة يم ثالث ركن .	BAS
تريد كريمة وشكر بكهوتك ؟	BAS
تكدر تصرف صك الميتين دولار مالتي ؟	BAS
اذا لازم يبين ، خابرني بلا زحمة .	BAS
وين الكهوة ؟	BAS
اريد سترة جهال .	BAS
اوكي . البريد العادي يكلف خمسة وثمانين سنت و بس تلث دولارات إضافية زيادة للتوصيل الخاص .	BAS
راح اشوف صعوبة ويه الكمارك ؟	BAS
عندك احذية رسمية عريضة من منطقة الأصابع ؟	BAS
لا . انا اقترح غرفة مزدوجة لاستخدام واحد افضل ؟ عدنا وحدة .	BAS
اريد كيرلي ضيق ، بلا زحمة .	BAS
هي تريد بيرة .	BAS
صباح الخير . شلونك ؟	BAS
اسف راح احتاج اشوف هوية .	BAS
شنو نوع الصوص ؟	BAS
قاعد غادي ، بالضبط قدام مكتب المعلومات السياحية .	BEN
ماعمريش سمعت بالعنوان هضا هنا .	BEN
أمشي طول لعند ما تشوف الصيدلية .	BEN
بكم الفطور ؟	BEN
كيف نقدر نساعدك ؟	BEN
أمشي يسار للشوكة الثالثة .	BEN
تبي كريمة و سكر في قهوتك ؟	BEN
تقدر تصرفلي شيك ميتين دولار بتاعي ؟	BEN
لو المفروض يبان ، كلمني لو سمحت .	BEN
وين الكافي ؟	BEN
نبي مالية بتاع أطفال .	BEN
اوكي . يكلف خمسة وثمانين سنت للبريد العادي و ثلاثة دولار بالضبط زيادة للتوصيل الخاص .	BEN
هل حيكون عندي أي صعوبه مع الجمرك ؟	BEN
عندك كندرة قفطان مفتوحة عند الصوابع ؟	BEN
لا . بس نقدر نقترح دار مزدوجة لاستعمال واحد بدالها ؟ عندنا واحدة .	BEN
نبي كيرلي مشدود ، لو سمحت .	BEN
هي تبي بيرة .	BEN
صباح الخير . كيف حالك ؟	BEN
اسف اني حنضطر نشوف أي نموذج كشف الهوية .	BEN
شن نوع الصوص ؟	BEN
راه تما ، بالضبط قبالت مكتب المعلومات ديال السياحة .	FES
ماسبقليش سمعت بهاد العنوان هنا .	FES
سير نيشان حتا تلقى الصيدلية .	FES
شحال الثمن ديال الفطور ؟	FES
كيفاش نقدر نساعدك ؟	FES
سيرعلى ليسر في الزاوية الثالثة .	FES
واش تبغي كريم وسكر في القهوة ديالك ؟	FES
واش ممكن تصرف الشيك ديالي ديال مئتي دولار ؟	FES
الى خصه يبان ، اتصل بيا عافاك .	FES
في كاين المقهى ؟	FES
بغيت لبيسة ديال الدراري الصغار .	FES
واخا . غادي يكلف خمسة وثمانين سنت للبريد العادي وثلاثة بالضبط ديال الدولار اضافية للتوصيل الخاص .	FES
واش غتكون عندي شي صعوبة مع الديوانة ؟	FES
واش عندك أحذية رسمية واسعة من جيهت الصبعين ؟	FES
لا . ممكن نقترح عليك عوض هادشي غرفة بجوج فراشات لشخص ؟ عندي واحدة .	FES
بغيت برمانونت ضيق ، عافاك .	FES
هي باغيا بيرة .	FES
صباح الخير . كيف داير ؟	FES
متأسف غادي نشوف شي اثبات ديال الهوية .	FES
شمن نوع ديال الصوص ؟	FES
هو هناك ، بالظبط أمام مكتب معلومات السياح .	KHA
ما حصل سمعت بالعنوان دا هنا .	KHA
أمشي دغري لغاية تشوف صيدلية .	KHA
بي كم الفطور ؟	KHA
كيف ممكن اساعدك ؟	KHA
أمشي شمال عند الكورنة التالتة .	KHA
داير كريمة و سكر في قهوتك ؟	KHA
هل يمكنك تصرف شيكي البي متين دولار ؟	KHA
اذا مفروض يظهر ، من فضلك اتصل على .	KHA
وين المقهى ؟	KHA
داير بلوفر أطفال .	KHA
اوكي . هو يكلف خمسة وتمنين سنت للبريد العادي و تلاتة دولارات بالظبط زيادة للتسليم الخاص .	KHA
ح أواجه أي صعوبات مع الجمارك ؟	KHA
هل عندك جزمة رسمي عريضة عند اصابع القدم ؟	KHA
لا . ممكن اقترح غرفة مزدوجة لاستعمال شخص ؟ عندنا واحدة .	KHA
داير تجعيدة ضيقة ، من فضلك .	KHA
دايرة بيرة .	KHA
صباح الخير . كيفك ؟	KHA
آسف ح احتاج اشوف اثبات هوية .	KHA
ياتو نوع من الصوص ؟	KHA
هو هنوك ، بالضبط قدام مكتب المعلومات السياحيي .	MOS
ابد ما كن اسمعتو بهذا العنوان هوني .	MOS
امشي كبل الى ان اتشوف صيدليه .	MOS
بشقد التغيوقه ؟	MOS
اشون اطيق اساعدك ؟	MOS
غوح لليساغ عد ثالث زاويه .	MOS
اتغيذ كريمه وشكر بالقهوي مالتك ؟	MOS
تطيق تصرفلي شيك قيمتو ميتين دولار ؟	MOS
اذا لازم يبين ، رجاءا اتصل بيي .	MOS
وين مكان الجيخانه ؟	MOS
اغيد سترة اطفال .	MOS
اوكي . اتكلف خميسي وثمانين سنت للبريد الاعتيادي وثلاث دولارات بالضبط اضافية للتوصيل الخاص .	MOS
هل غاح اواجه اي صعوبات مع الجمارك ؟	MOS
عندك حذاء رسمي عغيض مكان الاصابع ؟	MOS
لا ، ممكن اقترح عليكم غرفة مزدوجة لاستخدام ويحد امبدالو ؟ عدنه ويحدة منها .	MOS
اغيد كيرلي قوي ، رجاءا .	MOS
هيه تغيد بيره .	MOS
صباح الخير . اشونك ؟	MOS
اسف انو لازم اشوف شوية اوراق اثبات شخصية .	MOS
اي نوع من الصوص ؟	MOS
اهو هناك ، بالضبط جدام امام مكتب المعلومات السياحية .	MUS
انا ماسمعت ابد بالهعنوان .	MUS
روح سيده حتى تشوف الصيدلية .	MUS
بجم سعر الريوق ؟	MUS
كيف اقدر اساعدك ؟	MUS
سير يسار للتقاطع الثالث .	MUS
تبا نحط لك كريم و سكر بالقهوة ؟	MUS
هل تقدر تصرفلي شيك بمائتي دولار ؟	MUS
اذا كان مفروض يبين ، اتصل فيني لو سمحت .	MUS
وين صاير المقهي ؟	MUS
أبغا سترة للأطفال .	MUS
انزين . وتكلف خمسة وثمانين سنتا للبريد العادي وثلاثة دولارات بالضبط إضافية للتسليم الخاص .	MUS
هل واجهت أي صعوبه مع الجمارك ؟	MUS
عندك جواتي رسمية واسعة ؟	MUS
لا . ممكن أقترح غرفة مزدوجة لاستخدام شخص بدلا من ذلك ؟ عندنا واحدة .	MUS
أبا كيرلي قوي ، من فضلك .	MUS
هي تبا بيره .	MUS
صباح الخير . كيف حالك ؟	MUS
اسف احتاج اشوف اثبات للهوية .	MUS
أي نوع من الصوص ؟	MUS
هيو هناك ، بالزبط قدام مكتب معلومات السياح .	SAL
ما عمري سمعت عن هالعنوان هون .	SAL
روح دغري حتى تشوف الصيدلية .	SAL
قديش حق هالفطور ؟	SAL
كيف بقدر اساعدك ؟	SAL
روح شمال عند الزاوية الثالثة .	SAL
بتحب كريما و سكر بقهوتك ؟	SAL
بتقدر تصرف هاد الشيك تبعي بميتين دولار ؟	SAL
اذا لازم يظهر ، لو سمحت احكي معي .	SAL
وين الكوفي شوب ؟	SAL
بدي بلوفر للأطفال .	SAL
ماشي ، رح يكلف خمس و ثمانين سينت للبريد العادي ، و ثلاثة دولار بالزبط اضافية للتوصيل الخاص .	SAL
رح يكون عندي مشاكل مع الجمارك ؟	SAL
عندك احذية رسمية واسعة عند الاصابع ؟	SAL
لا . بقدر اقترح بدالها استخدام غرفة مزدوجة لاستعمال فرد ؟ عنا واحدة .	SAL
بدي كيرلي قوي ، لو سمحت .	SAL
بدي بيرم رفيع ، لو سمحت .	SAL
بدها بيرة ؟	SAL
اسف اني بحاجة أشوف اثبات هوية .	SAL
اي نوع من الصوص ؟	SAL
اوني غادي ، قدام متاع معلومات السواح بالضبط .	TRI
ماعمريش سمعت بيه العنوان هدا هنايا .	TRI
برا طول لين تشوف صيدلية .	TRI
بقداش الفطور ؟	TRI
كيف نقدر نساعدك ؟	TRI
عند تالت تقاطع خود يسار .	TRI
تبي حليب و سكر في قهوتك ؟	TRI
ممكن تصرفلي الشيك متاعي الي بميتين دولار ؟	TRI
كانا لازم يبان ، كلمني لو سمحت .	TRI
وين مكان القهوه ؟	TRI
نبي ماليه متاع صغار .	TRI
باه . حتكلفك خمسه و تمانين سنت للبريد العادي و تلاته دولار بالضبط زيادة للتوصيل الخاص .	TRI
زعمه حنلاقي صعوبات مع الجمارك ؟	TRI
هل عنك كنادر رسميه واسعه من القدام ؟	TRI
لا . نقدر نقترح عليك دار متاع اتنين لكن لإستخدام فردي ؟ عندنا واحدة .	TRI
نبي كيرلي ضيق ، لو سمحت .	TRI
هي تبي بيره .	TRI
صباح الخير . كيف حالك ؟	TRI
معليشي نبي نشوف اي بطاقة تعريف ليك .	TRI
اي نوع من الصوص ؟	TRI
